11111111111111111111111
1C000000000000100000001
1000000000000000000C001
110111000111100C0000011
1E000000001111000001001
111111110011100P0000011
10000000000001000000001
10C00000000001000000001
1101110010111100000C001
10000000000C00000000001
11111111111111111111111