11111111111111111111111111
1000000C000000000C000000C1
10001110110110101000111001
10P010C0101010001000100001
10C0111C100010101000110E01
100010001000101010001000C1
10001110100010101110111001
1000C00000C000000C000C0001
11111111111111111111111111