1111111111
1P11010001
1011011101
10CC011001
1111010011
1111010111
1111C000E1
1111111111